11111111111111111
100C01000000000C1
10000000111100001
1P0000011E0000C01
11111111111111111