1111111111111
1PE0000000001
10C0000000001
1111111111111